10
A.-.-.G.S.W.S.-.B.G
-.-.G.B.-.S.-.B.P.B
-.G.B.P.B.-.-.-.B.-
G.-.B.P.B.-.G.-.-.-
-.-.B.P.B.-.-.S.-.-
-.-.-.B.-.-.S.W.S.-
B.G.-.-.S.-.-.S.-.-
P.B.-.S.W.S.S.W.S.G
B.-.-.-.S.-.-.S.G.B
P.B.-.S.W.S.-.G.B.P
