10
G.B.-.-.G.G.-.S.G.G
B.P.B.-.-.-.S.W.S.G
-.B.P.B.-.-.-.S.W.S
-.-.B.-.-.-.-.-.S.-
-.-.-.-.B.-.B.-.-.-
G.-.-.B.P.B.P.B.-.-
S.G.-.-.B.-.B.-.S.-
W.S.G.-.-.S.-.S.W.S
S.W.S.-.S.W.S.-.S.-
A.S.G.-.G.S.-.G.G.G
