10
-.S.-.G.-.-.-.-.S.-
S.W.S.-.G.-.-.S.W.S
-.W.-.-.-.G.-.-.S.-
-.-.G.-.B.-.G.-.-.-
-.G.G.B.P .B.-.-.-.-
-.-.B.P.AB.G.G.G.G.G
-.-.-.B.G.G.G.B.-.-
-.S.-.-.G.G.B.P.B.-
S.W.S.-.G.B.P.P.B.-
-.W.-.-.G.-.B.B.-.-