10
G.G.S.-.-.-.B.P.B.A
G.S.W.S.-.-.-.B.-.-
S.W.S.-.-.-.-.B.-.G
-.S.B.B.-.-.B.P.B.-
-.B.P.P.B.-.-.B.-.-
-.-.B.B.-.S.-.B.G.-
B.B.B.-.S.W.S.-.-.G
P.P.P.B.-.S.-.G.-.-
B.B.B.-.-.B.-.-.-.B
G.G.G.G.B.P.B.G.B.P