10
-.-.-.-.-.-.-.-.-.-
-.G.-.G.-.G.-.G.-.G
-.-.-.G.-.-.-.-.-.-
-.G.G.-.B.B.-.-.-.B
-.-.-.B.P.P.B.-.B.P
-.G.-.B.P.B.-.B.P.B
-.-.-.-.B.-.-.-.B.-
-.G.-.-.-.B.-.-.-.G
-.-.-.-.B.P.B.-.-.-
-.G.-.B.P.B.-.G.-.A
